1,7,0,9,1
2,0,0,0,5
2,0,0,0,5
2,0,0,0,5
2,0,0,0,5
2,0,0,0,5
2,0,0,0,5
2,0,0,0,5
2,0,0,0,5
1,6,0,8,1
1,1,3,1,1
1,1,1,1,1
